8 8
--###---
--#.#---
--# ####
###$ $.#
#. $@###
####$#--
---#.#--
---###--