9 9
#####----
#@  #----
# $$#-###
# $ #-#.#
### ###.#
-##    .#
-#   #  #
-#   ####
-#####---