8 6
-####-
##  #-
#@$ #-
##$ ##
## $ #
#.$  #
#..*.#
######