8 8
-#####--
-#  ###-
-#@$  #-
### # ##
#.# #  #
#.$  # #
#.   $ #
########