7 10
-#######--
-#     ###
##$###   #
# @ $  $ #
# ..# $ ##
##..#   #-
-########-